NO ./textur/test_no.png             
SO ./textur/test_so.png
EA ./textur/test_ea.png
WE ./textur/test_we.png

C 85,34,20

F 1,86,103

111111111111111111111111
1000000000010000000000001
1000000000000001000000001
1000000100101010000000001
1000010000000000100000001
1000000100W00010000000001
1000000000010000000000001
1000001001000100000000001
111111111111111111111111
