NO ./textur/test_no.png             
SO              ./textur/test_so.png
EA ./textur/test_ea.png
WE ./textur/test_we.png

C 225,30,0

F 220,100,0

111111111111111111111111
1000000000010000000000001
1000000000000001000000001
1000000100101010000000001
10000100000W0000100000001
10000001000000100000000001
1000000000010000000000001
1000001001000100000000001
111111111111111111111111
